. . . . O
. O . O .
. . . . .
P . O . .
. . O . F